................
........E.......
........w.......
......j.w.......
...p....w.......
..fffffff.......
................
.......ffffff...
................