f...............
........E.......
........w.......
...p..j.w.......
........w.......
..fffffff.......
................
.......ffffff...
................